5 5 5 5 5 5 5 5 5 5 5 5 5 5 5
5 5 5 5 5 5 5 5 5 5 5 5 5 5 5
2 2 2 2 2 0 0 0 0 0 2 2 2 2 2
2 1 2 1 2 0 0 1 0 0 2 1 2 1 2
4 4 4 4 4 0 0 0 0 0 4 4 4 4 4
4 4 1 4 4 4 4 4 4 4 4 4 1 4 4
3 3 3 3 3 3 3 3 3 3 3 3 3 3 3
3 3 3 3 3 3 3 3 3 3 3 3 3 3 3